...............................
...............................
...............................
...............................
...............................
...............................
...............................
...............................
...............................
...............................
....P..........................
...............................
...............................
...............................
DDDDDDDDDDDDDDDDDDDDDDDDDDDDDDD
DDDDDDDDDDDDDDDDDDDDDDDDDDDDDDD
DDDDDDDDDDDDDDDDDDDDDDDDDDDDDDD