...............................
...............................
...............................
...............................
...............................
...............................
...............................
...............................
...............................
...............................
....P...................E......
...............................
...............................
...............................
DDDDDDDDDDDDDDDDDDDDDDDDDDDDDDD
DDDDDDDDDDDDDDDDDDDDDDDDDDDDDDD
DDDDDDDDDDDDDDDDDDDDDDDDDDDDDDD